mermaid of druid lake and other stories|the mermaid of druid lake and other stories|1
merry adventures of robin hood|the merry adventures of robin hood|1
middle of things|the middle of things|1
mill on the floss|the mill on the floss|1
mind that found itself an autobiography|a mind that found itself an autobiography|1
miscellany of men|a miscellany of men|1
money moon a romance|the money moon a romance|1
monk and the hangman's daughter|the monk and the hangman's daughter|1
monk a romance|the monk a romance|1
moon and sixpence|the moon and sixpence|1
more english fairy tales|more celtic fairy tales|1
mother's dream and other poems|the mother's dream and other poems|1
motor girls on a tour|the motor girls on a tour|1
mr. trunnell mate of the ship' pirate'|mr. trunnell mate of the ship pirate|2
mummy and miss nitocris a phantasy of the fourth dimension|the mummy and miss nitocris a phantasy of the fourth dimension|1
mutiny of the elsinore|the mutiny of the elsinore|1
mysteries of udolpho|the mysteries of udolpho|1
mysterious key and what it opened|the mysterious key and what it opened|1
mystery of 31 new inn|the mystery of 31 new inn|1
mystery of a hansom cab|the mystery of a hansom cab|1
mystery of a turkish bath|the mystery of a turkish bath|1
mystery of cloomber|the mystery of cloomber|1
mystery of edwin drood|the mystery of edwin drood|1
mystery of mary|the mystery of mary|1
mystery of the four fingers|the mystery of the four fingers|1
mystery of the hasty arrow|the mystery of the hasty arrow|1
mystery of the hidden room|the mystery of the hidden room|1
mystery of the locks|the mystery of the locks|1
mystery of the sea|toilers of the sea|1
mystery of the sea|the mystery of the sea|1
mystery of the yellow room|the mystery of the yellow room|1
napoleon of notting hill|the napoleon of notting hill|1
narrative of the expedition to botany bay|a narrative of the expedition to botany bay|1
narrative of the life and adventures of henry bibb an american slave|narrative of the life and adventures of henry bibb an american slave written by himself|3
narrative of the life of frederick douglass version 2|narrative of the life of frederick douglass an american slave|3
necessity of atheism|the necessity of atheism|1
negro explorer at the north pole|a negro explorer at the north pole|1
night of the long knives|the night of the long knives|1
ninth vibration and other stories|the ninth vibration and other stories|1
noble woman the life story of edith cavell|a noble woman the life story of edith cavell|1
nomad of the nine lives|the nomad of the nine lives|1
old coast road from boston to plymouth|the old coast road from boston to plymouth|1
old fashioned fairy book|the old fashioned fairy book|1
old fashioned fairy tales|old french fairy tales|1
old man in the corner|the old man in the corner|1
old man's love|an old man's love|1
old wives' tale|the old wives' tale|1
olive fairy book|the olive fairy book|1
once on a time|once upon a time|1
on the duty of civil disobedience version 2|on the duty of civil disobedience|2
on the nature of things leonard translation|on the nature of things|2
on the nature of things watson translation|on the nature of things|2
ordeal of elizabeth|the ordeal of elizabeth|1
ordeal of mark twain|the ordeal of mark twain|1
orpheus c. kerr papers vol 1|the orpheus c. kerr papers series 1|2
other side of the door|the other side of the door|1
other side of the sun fairy stories|the other side of the sun fairy stories|1
outcast of the islands|an outcast of the islands|1
outlaw of torn|the outlaw of torn|1
outspan tales of south africa|the outspan tales of south africa|1
oxford book of american essays|the oxford book of american essays|1
pair of blue eyes|a pair of blue eyes|1
astounding stories 19 july 1931|astounding stories july 1931|1
auriol or the elixir of life|septimius felton or the elixir of life|2
autobiography of anthony trollope|an autobiography of anthony trollope|1
autobiography of a slander|the autobiography of a slander|1
autobiography of benjamin franklin|the autobiography of benjamin franklin|1
autobiography of charles darwin|the autobiography of charles darwin|1
autobiography of methuselah|the autobiography of methuselah|1
palace in the garden|the palace in the garden|1
passenger from calais|the passenger from calais|1
peace on earth good will to dogs version 2|peace on earth good will to dogs|2
pee wee harris|pee wee harris adrift|1
pentecost of calamity|the pentecost of calamity|1
people of the abyss|the people of the abyss|1
people of the crater|the people of the crater|1
people of the mist|the people of the mist|1
people that time forgot|the people that time forgot|1
personal memoirs of u. s. grant|personal memoirs of u. s. grant volume 1|2
personal memoirs of u. s. grant|personal memoirs of u. s. grant volume 2|2
personal memoirs of u. s. grant|personal memoirs of u. s. grant part 1|2
personal memoirs of u. s. grant|personal memoirs of u. s. grant part 2|2
personal memoirs of u. s. grant|personal memoirs of u. s. grant part 5|2
personal memoirs of u. s. grant|personal memoirs of u. s. grant part 6|2
personal narrative of travels to the equinoctial regions of america during the years 1799 1804 vol.1|personal narrative of travels to the equinoctial regions of america during the year 1799 1804 volume 2|3
personal narrative of travels to the equinoctial regions of america during the years 1799 1804 vol.2|personal narrative of travels to the equinoctial regions of america during the year 1799 1804 volume 2|3
personal narrative of travels to the equinoctial regions of america during the years 1799 1804 vol.3|personal narrative of travels to the equinoctial regions of america during the year 1799 1804 volume 2|3
phantom of the opera|the phantom of the opera|1
phantom town mystery|the phantom town mystery|1
philosophy of style|the philosophy of style|1
picture book of merry tales|a picture book of merry tales|1
pink fairy book|the pink fairy book|1
pirates of ersatz|the pirates of ersatz|1
plan and preface to a dictionary of the english language|preface to a dictionary of the english language|2
poems by currer ellis and acton bell version 2|poems by currer ellis and acton bell|2
poems of giacomo leopardi|the poems of giacomo leopardi|1
poetical works of thomas hood|the poetical works of thomas hood|1
poor little rich girl|the poor little rich girl|1
portion of labor|the portion of labor|1
port of missing men|the port of missing men|1
portrait of a lady version 2|the portrait of a lady volume 2|2
practical guide to self hypnosis|a practical guide to self hypnosis|1
prairie schooner princess|a prairie schooner princess|1
praise of folly|the praise of folly|1
preface to politics|a preface to politics|1
price of love|the price of love|1
prince and betty|the prince and betty|1
prince of good fellows|a prince of good fellows|1
princess and curdie|the princess and curdie|1
princess and the goblin|the princess and the goblin|1
princess and the goblin|the princess and the goblin|1
princess priscilla's fortnight|the princess priscilla's fortnight|1
prisoner of zenda|the prisoner of zenda|1
problems of philosophy|the problems of philosophy|1
pursuit of god|the pursuit of god|1
quest of the sacred slipper|the quest of the sacred slipper|1
ragged trousered philanthropists|the ragged trousered philanthropists|1
rayner slade amalgamation|the rayner slade amalgamation|1
real mother goose|the real mother goose|1
rebel of the school|the rebel of the school|1
red badge of courage an episode of the american civil war|the red badge of courage an episode of the american civil war|1
red badge of courage an episode of the american civil war|the red badge of courage an episode of the american civil war|1
red cross girls with the russian army|the red cross girls with the russian army|1
red flower poems written in war time|the red flower poems written in war time|1
red house mystery|the red house mystery|1
red thumb mark|the red thumb mark|1
return of dr. fu manchu|the return of dr. fu manchu|1
return of tarzan|the return of tarzan|1
return of the soldier|the return of the soldier|1
revolt of the angels|the revolt of the angels|1
richard iii makers of history series|richard iii makers of history|1
riddle of the frozen flame|the riddle of the frozen flame|1
ride to the lady and other poems|the ride to the lady and other poems|1
rime of the ancient mariner|the rime of the ancient mariner|1
rise of silas lapham|the rise of silas lapham|1
river war an account of the reconquest of the sudan|the river war an account of the reconquest of the sudan|1
road to oz|the road to oz|1
robinson crusoe in words of one syllable version 2|robinson crusoe in words of one syllable|2
romance of a christmas card|the romance of a christmas card|1
romance of an old fool|the romance of an old fool|1
romance of rubber|the romance of rubber|1
room in the dragon volant|the room in the dragon volant|1
rose and roof tree|rose and roof tree poems|1
rose and the ring|the rose and the ring|1
rose garden husband|the rose garden husband|1
rustlers of pecos county|the rustlers of pecos county|1
saga of gunnlaug the worm tongue and raven the skald|the story of gunnlaug the worm tongue and raven the skald 1875|3
saint george for england|st. george for england|1
sara crewe or what happened at miss minchin's boarding school|sara crewe or what happened at miss minchin's|2
schoolmaster and other stories|the schoolmaster and other stories|1
science of being well|the science of being well|1
second jungle book|the second jungle book|1
second jungle book|the second jungle book|1
second thoughts of an idle fellow|the second thoughts of an idle fellow|1
secresy or the ruin on the rock|secresy or ruin on the rock|1
secret of dreams|the secret of dreams|1
secret of lonesome cove|the secret of lonesome cove|1
secret of the night|the secret of the night|1
secret places of the heart|the secret places of the heart|1
seen and the unseen|seen and unseen|1
selected poems by currer ellis and acton bell|poems by currer ellis and acton bell|1
selections from battle pieces and aspects of the war|battle pieces and aspects of the war|2
series of lessons in raja yoga|a series of lessons in raja yoga|1
seven lamps of architecture|the seven lamps of architecture|1
seven poor travellers|the seven poor travellers|1
seven sleuths' club|the seven sleuths' club|1
seven wives and seven prisons or experiences in the life of a matrimonial monomaniac|seven wives and seven prisons or experiences in the life of a matrimonial monomaniac a true story|3
sex avoided subjects discussed in plain english version 2|sex avoided subjects discussed in plain english|2
sex life of the gods|the sex life of the gods|1
shadow of a man|the shadow of a man|1
shepherd of the hills|the shepherd of the hills|1
sheridan road mystery|the sheridan road mystery|1
ballad of st. barbara and other verses|the ballad of st. barbara and other verses|1
ball and the cross|the ball and the cross|1
basket of flowers|the basket of flowers|1
beacon lights of history vol 1 the old pagan civilizations|beacon lights of history volume 01 the old pagan civilizations|2
beacon lights of history vol 3 ancient achievements|beacon lights of history volume 03 ancient achievements|2
beacon lights of history vol 6 renaissance and reformation|beacon lights of history volume 06 renaissance and reformation|2
beacon lights of history vol 7 great women|beacon lights of history volume 07 great women|2
beacon lights of history vol 8 great rulers|beacon lights of history volume 08 great rulers|2
beast in the jungle|the beast in the jungle|1
beasts of tarzan|the beasts of tarzan|1
bee man of orn and other fanciful tales|the bee man of orn and other fanciful tales|1
bel ami or the history of a scoundrel|bel ami or the history of a scoundrel a novel|2
bells of san juan|the bells of san juan|1
ben hur a tale of the christ book 1|ben hur a tale of the christ|2
best american humorous short stories|the best american humorous short stories|1
short history of england|a short history of england|1
short history of the united states|comic history of the united states|1
short line war|the short line war|1
singing man a book of songs and shadows|the singing man a book of songs and shadows|1
singing mouse stories|the singing mouse stories|1
sir francis drake|sir francis drake revived|1
sisters' tragedy with other poems lyrical and dramatic|the sisters' tragedy with other poems lyrical and dramatic|1
slave is a slave|a slave is a slave|1
slipper point mystery|the slipper point mystery|1
small boy and others|a small boy and others|1
smoky god or a voyage to the inner world|the smoky god or a voyage to the inner world|1
snow bound a winter idyl|snow bound a winter idyll|1
some turns of thought in modern philosophy|some turns of thought in modern philosophy five essays|2
song of hiawatha|the song of hiawatha|1
song of roland|the song of roland|1
song of the cardinal|the song of the cardinal|1
song of the guns|a song of the guns|1
song of the lark|the song of the lark|1
son of tarzan|the son of tarzan|1
sorrows of young werther|the sorrows of young werther|1
soul of a people|the soul of a people|1
spaceship named mcguire|a spaceship named mcguire|1
spell of egypt|the spell of egypt|1
spell of the yukon and other verses|the spell of the yukon and other verses|1
spirit of place and other essays|the spirit of place and other essays|1
spirit of sweetwater|the spirit of sweetwater|1
spirit of the border|johnstone of the border|1
spirit of youth and the city streets|the spirit of youth and the city streets|1
spoils of poynton|the spoils of poynton|1
sport of the gods|the sport of the gods|1
staircase at the heart's delight|the staircase at the heart's delight 1894|2
star chamber an historical romance volume 1|the star chamber an historical romance volume 1|1
star chamber an historical romance volume 1|the star chamber an historical romance volume 2|2
star chamber an historical romance volume 2|the star chamber an historical romance volume 1|2
star chamber an historical romance volume 2|the star chamber an historical romance volume 2|1
stars my brothers|the stars my brothers|1
star treader and other poems|the star treader and other poems|1
st. george and st. michael volume 1|st. george and st. michael volume 2|1
st. george and st. michael volume 1|st. george and st. michael volume 3|1
st. george and st. michael volume 1|st. george and st. michael|2
st. george and st. michael volume 2|st. george and st. michael volume 1|1
st. george and st. michael volume 2|st. george and st. michael volume 3|1
st. george and st. michael volume 2|st. george and st. michael|2
stories by foreign authors german authors volume 1|stories by foreign authors german volume 1|1
stories by foreign authors german authors volume 1|stories by foreign authors german volume 2|2
stories from pentamerone|stories from the pentamerone|1
stories from wagner|opera stories from wagner|1
stories of king arthur and his knights|the legends of king arthur and his knights|2
stories of king arthur and his knights|king arthur and his knights|2
stories of king arthur's knights told to the children|stories of king arthur's knights told to the children by mary macgregor|3
story of a bad boy|the story of a bad boy|1
story of a bold tin soldier|the story of a bold tin soldier|1
story of a calico clown|the story of a calico clown|1
story of a candy rabbit|the story of a candy rabbit|1
story of a common soldier of army life in the civil war 1861 1865|the story of a common soldier of army life in the civil war 1861 1865|1
story of a lamb on wheels|the story of a lamb on wheels|1
story of an african farm|the story of an african farm|1
story of a nodding donkey|the story of a nodding donkey|1
story of a plush bear|the story of a plush bear|1
story of a stuffed elephant|the story of a stuffed elephant|1
story of geronimo|the story of geronimo|1
story of john wesley told to boys and girls|the story of john wesley told to boys and girls|1
story of king arthur and his knights|the legends of king arthur and his knights|2
story of king arthur and his knights|king arthur and his knights|2
story of mary maclane|the story of mary maclane|1
story of one short life 1783 to 1818|a story of one short life 1783 to 1818|1
story of scraggles|the story of scraggles|1
story of the amulet|the story of the amulet|1
story of the other wise man|the story of the other wise man|1
story of the other wise man|the story of the other wise man|1
story of the three little pigs|the story of the three little pigs|1
story of wool|the story of wool|1
story of young abraham lincoln|the story of young abraham lincoln|1
stowmarket mystery or a legacy of hate|the stowmarket mystery or a legacy of hate|1
strange adventures of eric blackburn|the strange adventures of eric blackburn|1
strange case of dr. jekyll and mr. hyde|the strange case of dr. jekyll and mr. hyde|1
strange manuscript found in a copper cylinder|a strange manuscript found in a copper cylinder|1
street of seven stars|the street of seven stars|1
strength of gideon and other stories|the strength of gideon and other stories|1
stretton street affair|the stretton street affair|1
subjection of women|the subjection of women|1
suppressed poems of alfred lord tennyson|the suppressed poems of alfred lord tennyson|1
suppressed poems of alfred lord tennyson|the early poems of alfred lord tennyson|2
surprising adventures of baron munchausen|the surprising adventures of baron munchausen|1
surprising adventures of the magical monarch of mo and his people|the surprising adventures of the magical monarch of mo and his people|1
survivors of the chancellor|the survivors of the chancellor|1
sweet little maid|a sweet little maid|1
swiss family robinson in words of one syllable|the swiss family robinson told in words of one syllable|2
sword of welleran and other stories|the sword of welleran and other stories|1
sylvie and bruno concluded|sylvie and bruno|1
tale of benny badger|the tale of benny badger|1
tale of brownie beaver|the tale of brownie beaver|1
tale of chirpy cricket|the tale of chirpy cricket|1
tale of cuffy bear|the tale of cuffy bear|1
tale of dickie deer mouse|the tale of dickie deer mouse|1
tale of fatty coon|the tale of fatty coon|1
tale of freddie firefly|the tale of freddie firefly|1
tale of grandfather mole|the tale of grandfather mole|1
tale of henrietta hen|the tale of henrietta hen|1
tale of kiddie katydid|the tale of kiddie katydid|1
tale of major monkey|the tale of major monkey|1
tale of master meadow mouse|the tale of master meadow mouse|1
tale of pony twinkleheels|the tale of pony twinkleheels|1
tale of reddy woodpecker|the tale of reddy woodpecker|1
tale of rusty wren|the tale of rusty wren|1
tale of three lions|a tale of three lions|1
tale of timothy turtle|the tale of timothy turtle|1
tale of tommy fox|the tale of tommy fox|1
tale of two cities|a tale of two cities|1
teeth of the tiger|the teeth of the tiger|1
terror a mystery|the terror a mystery|1
that lass o' lowrie's|that lass o' lowrie's 1877|1
thing from the lake|the thing from the lake|1
third miss symons|the third miss symons|1
thirty nine steps|the thirty nine steps|1
three men in a boat to say nothing of the dog version 2|three men in a boat to say nothing of the dog|2
three mulla mulgars|the three mulla mulgars|1
through glacier park seeing america first with howard eaton version 2|through glacier park seeing america first with howard eaton|2
tiny story book|the tiny story book|1
tis the last rose of summer|the last rose of summer|1
told in a french garden|told in a french garden august 1914|2
told in the coffee house|told in the coffee house turkish tales|2
torrents of spring|the torrents of spring|1
to the last man|the last man|1
touch of the sun and other stories|a touch of sun and other stories|2
tower of dago|the tower of dago|1
tragedy of the korosko|the tragedy of the korosko|1
trail of the hawk a comedy of the seriousness of life|the trail of the hawk a comedy of the seriousness of life|1
trail of the lonesome pine|the trail of the lonesome pine|1
training of a forester|the training of a forester|1
traveller in war time|a traveller in war time|1
traveller in war time|cuba in war time|1
travel stories retold from st. nicholas|southern stories retold from st. nicholas|1
travel stories retold from st. nicholas|indian stories retold from st. nicholas|1
treatise on good works|a treatise on good works|1
trees of pride|the trees of pride|1
trial of callista blake|the trial of callista blake|1
trimmed lamp and other stories of the four million|the trimmed lamp and other stories of the four million|1
triumphs of eugene valmont|the triumphs of eugene valmont|1
true stories from history and biography|true stories of history and biography|1
tunnel under the world|the tunnel under the world|1
tyranny of weakness|the tyranny of weakness|1
u boat hunters|the u boat hunters|1
uncle silas a tale of bartram haugh version 2|uncle silas a tale of bartram haugh|2
unhappy far off things|far off things|1
unsolved riddle of social justice|the unsolved riddle of social justice|1
upas tree a christmas story for all the year|the upas tree a christmas story for all the year|1
upward path a reader for colored children|the upward path a reader for colored children|1
valley of decision|the valley of decision|1
valley of the giants|the valley of the giants|1
valley of the moon|the valley of the moon|1
vanished arizona recollections of the army life of a new england woman|vanished arizona recollections of the army life by a new england woman|1
verse book of a homely woman|the verse book of a homely woman|1
vicar of bullhampton|the vicar of bullhampton|1
vicar of tours|the vicar of tours|1
vicar of wrexhill|the vicar of wrexhill|1
violet fairy book|the violet fairy book|1
visit to the holy land egypt and italy|a visit to the holy land egypt and italy|1
voyage towards the south pole and round the world|a voyage towards the south pole and round the world volume 2|3
wallet of kai lung|the wallet of kai lung|1
war in the air|the war in the air|1
war is kind collection|war is kind|1
war poems of siegfried sassoon|the war poems of siegfried sassoon|1
warwickshire lad the story of the boyhood of william shakespeare|a warwickshire lad the story of the boyhood of william shakespeare|1
watch and wait the young fugitives|watch and wait or the young fugitives|1
water ghost and others|the water ghost and others|1
way of all flesh|the way of all flesh|1
way of peace|the way of peace|1
way of the wind|the way of the wind|1
what men live by and other tales version 2|what men live by and other tales|2
white jacket or the world in a man of war|white jacket or the world on a man of war|1
white linen nurse|the white linen nurse|1
white wolf and other fireside tales|the white wolf and other fireside tales|1
whole family a novel by twelve authors|the whole family a novel by twelve authors|1
wild knight and other poems|the wild knight and other poems|1
wind among the reeds|the wind among the reeds|1
wind in the willows|the wind in the willows|1
wind in the willows|the wind in the willows|1
window at the white cat|the window at the white cat|1
wisdom of father brown|the wisdom of father brown|1
witches of new york|the witches of new york|1
witch shall be born|a witch shall be born|1
woman in the alcove|the woman in the alcove|1
woman in the nineteenth century|liberty in the nineteenth century|1
woman in white|the woman in white|1
woman of mystery|the woman of mystery|1
woman of the world her counsel to other people's sons and daughters|a woman of the world her counsel to other people's sons and daughters|1
woman's experiences in the great war|a woman's experiences in the great war|1
woman who did|the woman who did|1
woman who went to alaska|a woman who went to alaska|1
wonderful adventures of nils|the wonderful adventures of nils|1
wood beyond the world|the wood beyond the world|1
work and win noddy newman on a cruise|work and win or noddy newman on a cruise|1
world i live in|the world i live in|1
world that couldn't be|the world that couldn't be|1
worshipper of the image|the worshipper of the image|1
wreck of the golden mary|the wreck of the golden mary|1
yankee girl at fort sumter|a yankee girl at fort sumter|1
yoga sutras of patanjali the book of the spiritual man version 3|the yoga sutras of patanjali the book of the spiritual man|3
young marooners on the florida coast|the young marooners on the florida coast|1
big bow mystery|the big bow mystery|1
biography of a prairie girl|the biography of a prairie girl|1
birds' christmas carol|the birds' christmas carol|1
birds' christmas carol|the birds' christmas carol|1
birthday party a story for little folks|the birthday party a story for little folks|1
black arrow a tale of the two roses|the black arrow a tale of two roses|2
black poodle and other tales|the black poodle and other tales|1
black riders and other lines|the black riders and other lines|1
black star passes|the black star passes|1
blue bird a fairy play in six acts|the blue bird a fairy play in six acts|1
blue jar story book|the blue jar story book|1
boat club or the bunkers of rippleton|the boat club or the bunkers of rippleton|1
bobbsey twins at meadow brook|the bobbsey twins at meadow brook|1
bobbsey twins at school|the bobbsey twins at school|1
bobbsey twins at snow lodge|the bobbsey twins at snow lodge|1
bobbsey twins in the country|the bobbsey twins in the country|1
bobbsey twins on a houseboat|the bobbsey twins on a houseboat|1
bobbsey twins or merry days indoors and out|the bobbsey twins or merry days indoors and out|1
bondage of the will|doctrine of the will|1
book of dragons|the book of dragons|1
book of ghosts|a book of ghosts|1
book of life|the book of life|1
book of old english ballads|the book of old english ballads|1
book of scoundrels|a book of scoundrels|1
book of tea|the book of tea|1
book of the national parks|the book of the national parks|1
book of wonder|the book of wonder|1
box car children|the box car children|1
boy scout and other stories for boys|the boy scout and other stories for boys|1
boy scouts in front of warsaw or in the wake of war|the boy scouts in front of warsaw or in the wake of war|1
boy scouts in russia|the boy scouts in russia|1
boys' life of abraham lincoln|the boys' life of abraham lincoln|1
brighton boys in the radio service|the brighton boys in the radio service|1
brown fairy book|the brown fairy book|1
brown fairy book|the brown fairy book|1
buccaneers and pirates of our coasts version 2|buccaneers and pirates of our coasts|2
abominations of modern society|the abominations of modern society|1
advance of science in the last half century|the advance of science in the last half century|1
adventures of a dog and a good dog too|the adventures of a dog and a good dog too|1
adventures of a suburbanite|the adventures of a suburbanite|1
adventures of buffalo bill|the adventures of buffalo bill|1
adventures of buster bear|the adventures of buster bear|1
adventures of ferdinand count fathom|the adventures of ferdinand count fathom complete|2
adventures of gerard|the adventures of gerard|1
adventures of grandfather frog|the adventures of grandfather frog|1
adventures of jimmie dale|the adventures of jimmie dale|1
adventures of jimmy skunk|the adventures of jimmy skunk|1
adventures of johnny chuck|the adventures of johnny chuck|1
adventures of maya the bee|the adventures of maya the bee|1
adventures of odysseus and the tale of troy|the adventures of odysseus and the tales of troy|2
adventures of old mr. toad|the adventures of old mr. toad|1
adventures of paddy beaver|the adventures of paddy beaver|1
adventures of poor mrs. quack|the adventures of poor mrs. quack|1
adventures of prickly porky|the adventures of prickly porky|1
adventures of roderick random|the adventures of roderick random|1
adventures of sally|the adventures of sally|1
burgess animal book for children|the burgess animal book for children|1
burgess bird book for children|the burgess bird book for children|1
burial of the guns|the burial of the guns|1
business of being a woman|the business of being a woman|1
buttered side down|buttered side down stories|1
camp fire girls at twin lakes or the quest of a summer vacation|campfire girls at twin lakes or the quest of a summer vacation|2
camp fire girls in the allegheny mountains or a christmas success against odds|campfire girls in the allegheny mountains or a christmas success against odds|2
captain of the polestar and other tales|the captain of the polestar and other tales|1
case of jennie brice|the case of jennie brice|1
case of the golden bullet|the case of the golden bullet|1
case of the pocket diary found in the snow|the case of the pocket diary found in the snow|1
case of the pool of blood in the pastor's study|the case of the pool of blood in the pastor's study|1
case of the registered letter|the case of the registered letter|1
case of wagner nietzsche contra wagner selected aphorisms|the case of wagner nietzsche contra wagner and selected aphorisms|2
celtic fairy tales|more celtic fairy tales|1
ceres runaway and other essays|ceres' runaway and other essays|1
changed man and other tales|a changed man and other tales|1
chautauqua girls at home|the chautauqua girls at home|1
chessmen of mars|the chessmen of mars|1
children's life of the bee|the children's life of the bee|1
child's book of the seasons|the child's book of the seasons|1
child's history of england|a child's history of england|1
chinese nightingale and other poems|the chinese nightingale and other poems|1
chorus girl and other stories|the chorus girl and other stories|1
chronicles of clovis|the chronicles of clovis|1
city of the sun|the city of the sun|1
clue of the twisted candle|the clue of the twisted candle|1
coast of bohemia|the coast of bohemia|1
coast of bohemia|the coast of bohemia|1
collected poems of rupert brooke|the collected poems of rupert brooke|1
collection of beatrix potter stories|a collection of beatrix potter stories|1
collection of stories reviews and essays|a collection of stories reviews and essays|1
comet and other verses|the comet and other verses|1
coming of the law|the coming of the law|1
complete book of cheese|the complete book of cheese|1
conduct of life|the conduct of life|1
confederate girl's diary|a confederate girl's diary|1
confession of a child of the century|the confession of a child of the century|1
confessions of a daddy|the confessions of a daddy|1
confessions of a poacher|the confessions of a poacher|1
confessions of arsene lupin|the confessions of arsene lupin|1
confidence man his masquerade|the confidence man his masquerade|1
conquest of bread|the conquest of bread|1
consolation of philosophy|the consolation of philosophy|1
country of the pointed firs|the country of the pointed firs|1
courage of marge o'doone|the courage of marge o'doone|1
creators a comedy|the creators a comedy|1
creature from cleveland depths|the creature from cleveland depths|1
crimes of england|the crimes of england|1
crimson fairy book|the crimson fairy book|1
crimson gardenia and other tales of adventure|the crimson gardenia and other tales of adventure|1
critique of practical reason|the critique of practical reason|1
cruise of the esmeralda|the cruise of the esmeralda|1
culprit fay and other poems|the culprit fay and other poems|1
custom of the country|the custom of the country|1
cynic looks at life|a cynic looks at life|1
czar's spy the mystery of a silent love version 2|the czar's spy the mystery of a silent love|3
damnation of theron ware|the damnation of theron ware|1
damsel in distress|a damsel in distress|1
dark night's work|a dark night's work|1
dash for a throne|a dash for a throne|1
daughter of the snows|a daughter of the snows|1
daughter of the vine|a daughter of the vine|1
dawn of all|the dawn of all|1
day at the county fair|a day at the county fair|1
death of the lion|the death of the lion|1
declaration of independence of the united states of america|the declaration of independence of the united states of america|1
defeat of youth and other poems|the defeat of youth and other poems|1
defence of guenevere and other poems|the defence of guenevere and other poems|1
descent of man and other stories|the descent of man and other stories|1
desert drama being the tragedy of the korosko|a desert drama being the tragedy of the korosko|1
devil in iron|the devil in iron|1
devolutionist and the emancipatrix|the devolutionist and the emancipatrix|1
diana of the crossways|diana of the crossways complete|1
diary of a goose girl|the diary of a goose girl|1
discourse upon the origin and the foundation of the inequality among mankind|a discourse upon the origin and the foundation of the inequality among mankind|1
doctor his wife and the clock|the doctor his wife and the clock|1
doctor's christmas eve|the doctor's christmas eve|1
dog of flanders|a dog of flanders|1
dog's book of verse|the dog's book of verse|1
dogs of boytown|the dogs of boytown|1
doings of raffles haw|the doings of raffles haw|1
dome of many coloured glass|a dome of many coloured glass|1
door in the wall and other stories|the door in the wall and other stories|1
door through space|the door through space|1
dorothy and the wizard in oz version 2|dorothy and the wizard in oz|2
dorothy and the wizard in oz version 2|dorothy and the wizard in oz|2
dorothy dale a girl of today|dorothy dale a girl of to day|2
double life of mr. alfred burton|the double life of mr. alfred burton|1
dragon and the raven or the days of king alfred|the dragon and the raven or the days of king alfred|1
drums of jeopardy|the drums of jeopardy|1
duke of chimney butte|the duke of chimney butte|1
edge of the knife|the edge of the knife|1
education of henry adams|the education of henry adams|1
egyptian tales translated from the papyri series two xviiith to xixth dynasty|egyptian tales translated from the papyri second series xviiith to xixth dynasty|2
adventures of ulysses|the adventures of ulysses|1
aesop's fables new translation|aesop's fables a new translation|1
airlords of han|the airlords of han|1
alphabet of history|an alphabet of history|1
altar of the dead|the altar of the dead|1
ambulance made two trips|the ambulance made two trips|1
elements of style|the elements of style|1
emerald city of oz|the emerald city of oz|1
emerald city of oz|the emerald city of oz|1
emma mcchesney and company|emma mcchesney and co|1
emperor of portugallia|the emperor of portugallia|1
english girl's first impressions of burmah|an english girl's first impressions of burmah|1
englishwoman's love letters|an englishwoman's love letters|1
enquiry concerning the principles of morals|an enquiry concerning the principles of morals|1
essay on the principle of population|an essay on the principle of population|1
essentials of spirituality|the essentials of spirituality|1
eventful history of the mutiny and piratical seizure of h.m.s. bounty its cause and consequences|the eventful history of the mutiny and piratical seizure of h.m.s. bounty its cause and consequences|1
expedition of humphry clinker|the expedition of humphry clinker|1
expedition of the donner party and its tragic fate|the expedition of the donner party and its tragic fate|1
exploits of brigadier gerard|the exploits of brigadier gerard|1
exploits of elaine|the exploits of elaine|1
expressman and the detective|the expressman and the detective|1
eye for an eye|an eye for an eye|1
eye for an eye|an eye for an eye|1
eye of dread|the eye of dread|1
eye of osiris|the eye of osiris|1
eyes of the world|the eyes of the world|1
facts of reconstruction|the facts of reconstruction|1
fairies and the christmas child|the fairies and the christmas child|1
fairy changeling and other poems|the fairy changeling and other poems|1
fall of troy|the fall of troy|1
famous affinities of history the romance of devotion|famous affinities of history the romance of devotion volume 1|2
father of women and other poems|a father of women and other poems|1
feast of st. friend|the feast of st. friend|1
few figs from thistles|a few figs from thistles|1
figure in the carpet|the figure in the carpet|1
finding of haldgren|the finding of haldgren|1
firelight fairy book|the firelight fairy book|1
firm of nucingen|the firm of nucingen|1
first men in the moon|the first men in the moon|1
flatland a romance of many dimensions version 2|flatland a romance of many dimensions|2
flaw in the crystal|the flaw in the crystal|1
florida sketch book|a florida sketch book|1
flowers of evil|the flowers of evil|1
folklore of the santal parganas vol 1|folklore of the santal parganas|2
following the equator a journey around the world|following the equator a journey around the world part 1|2
following the equator a journey around the world|following the equator a journey around the world part 2|2
following the equator a journey around the world|following the equator a journey around the world part 7|2
food of the gods and how it came to earth version 2|the food of the gods and how it came to earth|3
fool there was|a fool there was|1
fortune of the rougons|the fortune of the rougons|1
fortunes and misfortunes of the famous moll flanders|the fortunes and misfortunes of the famous moll flanders|1
fortunes of glencore|the fortunes of glencore|1
four horsemen of the apocalypse|the four horsemen of the apocalypse|1
four pools mystery|the four pools mystery|1
frankenstein or the modern prometheus 1818|frankenstein or the modern prometheus|1
frankenstein or the modern prometheus edition 1831|frankenstein or the modern prometheus|2
from the easy chair vol 2|from the easy chair volume 2|1
from the easy chair vol 3|from the easy chair volume 3|1
fruit of the tree|the fruit of the tree|1
further adventures of jimmie dale|the further adventures of jimmie dale|1
further adventures of robinson crusoe|the further adventures of robinson crusoe|1
futuria fantasia spring 1940|futuria fantasia winter 1940|1
game and the candle|the game and the candle|1
garden of eden|the garden of eden|1
garland for girls|a garland for girls|1
german deserter's war experience|a german deserter's war experience|1
gerrard street mystery and other weird tales|the gerrard street mystery and other weird tales|1
getting of wisdom|the getting of wisdom|1
ghost of guir house|the ghost of guir house|1
giant crab and other tales from old india|the giant crab and other tales from old india|1
gift of the magi|the gift of the magi|1
girl at central|the girl at central|1
girl aviators and the phantom airship|the girl aviators and the phantom airship|1
girl from montana|the girl from montana|1
girl from the marsh croft|the girl from the marsh croft|1
girl in the golden atom|the girl in the golden atom|1
girl next door|the girl next door|1
girl on the boat|the girl on the boat|1
girl who had nothing|the girl who had nothing|1
girl with the golden eyes|the girl with the golden eyes|1
glimpses of the moon|the glimpses of the moon|1
glugs of gosh|the glugs of gosh|1
gods are athirst|the gods are athirst|1
gods of pegana|the gods of pegana|1
golden goose book|the golden goose book|1
golden lion of granpere|the golden lion of granpere|1
golden slipper and other problems for violet strange|the golden slipper and other problems for violet strange|1
gold hunter's experience|a gold hunter's experience|1
goody naughty book|the goody naughty book|1
greatest thing in the world and other addresses|the greatest thing in the world and other addresses|1
great god pan|the great god pan|1
great gold rush a tale of the klondike|the great gold rush a tale of the klondike|1
great stone face and other tales of the white mountains|the great stone face and other tales of the white mountains|1
greek view of life|the greek view of life|1
green fairy book|the green fairy book|1
green flag and other stories of war and sport|the green flag and other stories of war and sport|1
green forest fairy book|the green forest fairy book|1
grey fairy book|the grey fairy book|1
grey fairy book|the grey fairy book|1
group of noble dames|a group of noble dames|1
growth of a soul|the growth of a soul|1
guards came through and other poems|the guards came through and other poems|1
guest of quesnay|the guest of quesnay|1
guide to health|a guide to health|1
guide to stoicism|a guide to stoicism|1
guy mannering or the astrologer|guy mannering or the astrologer complete|1
harbor of doubt|the harbor of doubt|1
haunted hotel a mystery of modern venice|the haunted hotel a mystery of modern venice|1
haunted hour an anthology|the haunted hour an anthology|1
hawk of egypt|the hawk of egypt|1
heath hover mystery|the heath hover mystery|1
heir of redclyffe|the heir of redclyffe|1
helping himself or grant thornton's ambition version 2|helping himself or grant thornton's ambition|2
heroes or greek fairy tales for my children|the heroes or greek fairy tales for my children|1
hero tales from american history version 2|hero tales from american history|2
hindu yogi science of breath|the hindu yogi science of breath|1
history of england from the accession of james ii volume 5 chapter 23|the history of england from the accession of james ii volume 5|3
history of england from the accession of james ii volume 5 chapter 24|the history of england from the accession of james ii volume 5|3
history of england from the accession of james ii volume 5 chapter 25|the history of england from the accession of james ii volume 5|3
history of henry esmond esq a colonel in the service of her majesty queen anne|the history of henry esmond esq a colonel in the service of her majesty queen anne|1
history of mr. polly|the history of mr. polly|1
angel of terror|the angel of terror|1
annals of ann|the annals of ann|1
history of the life of the late mr. jonathan wild the great|the history of the life of the late mr. jonathan wild the great|1
history of the peloponnesian war|the history of the peloponnesian war|1
hohenzollerns in america with the bolsheviks in berlin and other impossibilities|the hohenzollerns in america with the bolsheviks in berlin and other impossibilities|1
hollow needle further adventures of arsene lupin|the hollow needle further adventures of arsene lupin|1
honeymoon in space|a honeymoon in space|1
honor of the big snows|the honor of the big snows|1
hope of the gospel|the hope of the gospel|1
hound from the north|the hound from the north|1
hound of the baskervilles|the hound of the baskervilles|1
hound of the baskervilles|the hound of the baskervilles|1
house behind the cedars|the house behind the cedars|1
house boat on the styx|a house boat on the styx|1
house by the lock|the house by the lock|1
house in the mist|the house in the mist|1
house in the mist|the house in the mist|1
house of dust a symphony|the house of dust a symphony|1
house of gentlefolk|a house of gentlefolk|1
house of the vampire|the house of the vampire|1
house of the white shadows|the house of the white shadows|1
house on the borderland|the house on the borderland|1
house to let|a house to let|1
house with the green shutters|the house with the green shutters|1
house with the mezzanine and other stories|the house with the mezzanine and other stories|1
how to live on 24 hours a day version 2|how to live on 24 hours a day|2
how to live on twenty four hours a day|how to live on 24 hours a day|2
human boy and the war|the human boy and the war|1
hungry stones and other stories|the hungry stones and other stories|1
ice maiden and other tales|the ice maiden and other tales|1
idiot at home|the idiot at home|1
idle thoughts of an idle fellow|the second thoughts of an idle fellow|2
idle thoughts of an idle fellow|the idle thoughts of an idle fellow|1
indian heroes and great chieftans|indian heroes and great chieftains|1
innocence of father brown|the innocence of father brown|1
innocents a story for lovers|the innocents a story for lovers|1
insidious dr. fu manchu|the insidious dr. fu manchu|1
insurrection in dublin|the insurrection in dublin|1
intoxicated ghost and other stories|the intoxicated ghost and other stories|1
isle in the water|an isle in the water|1
jack knife man|the jack knife man|1
jewel of seven stars|the jewel of seven stars|1
jewels of aptor|the jewels of aptor|1
jimmyjohn boss and other stories|the jimmyjohn boss and other stories|1
journal of a tour to the hebrides with samuel johnson|the journal of a tour to the hebrides with samuel johnson ll.d|2
journal of a voyage to lisbon|the journal of a voyage to lisbon|1
journal of impressions in belgium|a journal of impressions in belgium|1
journal of submarine commander von forstner|the journal of submarine commander von forstner|1
journey in other worlds a romance of the future|a journey in other worlds a romance of the future|1
joyous story of toto|the joyous story of toto|1
just and the unjust|the just and the unjust|1
kalevala the epic poem of finland crawford translation|kalevala the epic poem of finland volume 02|2
king arthur's knights the tales retold for boys and girls|king arthur's knights the tales re told for boys and girls|2
king of ireland's son|the king of ireland's son|1
kitchen cat and other stories|the kitchen cat and other stories|1
knights of arthur|the knights of arthur|1
knyght ther was|a knyght ther was|1
lady of the basement flat|the lady of the basement flat|1
lady's captivity among chinese pirates in the chinese seas|a lady's captivity among chinese pirates in the chinese seas|1
lady's life in the rocky mountains|a lady's life in the rocky mountains|1
lady's life on a farm in manitoba|a lady's life on a farm in manitoba|1
lady's visit to the gold diggings of australia in 1852 53|a lady's visit to the gold diggings of australia in 1852 53|1
lady with the dog and other stories|the lady with the dog and other stories|1
lair of the white worm|the lair of the white worm|1
land of little rain|the land of little rain|1
land of little rain|the land of little rain|1
land that time forgot|the land that time forgot|1
last days of pompeii|the last days of pompeii|1
last of the plainsmen|the last of the plainsmen|1
law and the lady|the law and the lady|1
legacy of cain|the legacy of cain|1
legend of montrose|a legend of montrose|1
legends of king arthur and his knights|the legends of king arthur and his knights|1
letter of credit|the letter of credit|1
letters of ulysses s. grant to his father and his youngest sister|letters of ulysses s. grant to his father and his youngest sister 1857 78|2
letters to his son on the art of becoming a man of the world and a gentleman|letters to his son 1746 47 on the fine art of becoming a man of the world and a gentleman|3
letters to his son on the art of becoming a man of the world and a gentleman|letters to his son 1756 58 on the fine art of becoming a man of the world and a gentleman|3
letters to his son on the art of becoming a man of the world and a gentleman|letters to his son 1759 65 on the fine art of becoming a man of the world and a gentleman|3
letters to his son on the art of becoming a man of the world and a gentleman|letters to his son complete on the fine art of becoming a man of the world and a gentleman|2
library of the world's best mystery and detective stories volume 1|library of the world's best mystery and detective stories|2
library of the world's best mystery and detective stories volume 2|library of the world's best mystery and detective stories|2
library of the world's best mystery and detective stories volume 3|library of the world's best mystery and detective stories|2
library of the world's best mystery and detective stories volume 4|library of the world's best mystery and detective stories|2
library of the world's best mystery and detective stories volume 5|library of the world's best mystery and detective stories|2
library of the world's best mystery and detective stories volume 6|library of the world's best mystery and detective stories|2
life adventures and piracies of captain singleton|the life adventures and piracies of the famous captain singleton|3
life and adventures of sir launcelot greaves|the adventures of sir launcelot greaves|2
life crime and capture of john wilkes booth|the life crime and capture of john wilkes booth|1
life everlasting a reality of romance|the life everlasting a reality of romance|1
life in a mediaeval city illustrated by york in the xvth century|life in a medival city illustrated by york in the xvth century|1
life of honorable william f. cody known as buffalo bill the famous hunter scout and guide|the life of hon. william f. cody known as buffalo bill the famous hunter scout and guide an autobiography|4
life of saint columba apostle of scotland|the life of saint columba apostle of scotland|1
life of saint monica|the life of saint monica|1
life of the fly with which are interspersed some chapters of autobiography|the life of the fly with which are interspersed some chapters of autobiography|1
life of the spider|the life of the spider|1
life of thomas lord cochrane tenth earl of dundonald vol 1|the life of thomas lord cochrane tenth earl of dundonald vol i|2
light that failed|the light that failed|1
lilac fairy book|the lilac fairy book|1
lion and the unicorn|the lion and the unicorn|1
lion of saint mark a story of venice in the fourteenth century|the lion of saint mark a story of venice in the fourteenth century|1
little book of christmas|a little book of christmas|1
little bush maid|a little bush maid|1
little colonel's hero|the little colonel's hero|1
little colonel's knight comes riding|the little colonel's knight comes riding|1
little country girl|a little country girl|1
little florida lady|a little florida lady|1
little house in the fairy wood|the little house in the fairy wood|1
little swiss sojourn|a little swiss sojourn|1
london and country brewer|the london and country brewer|1
lone ranger rides|the lone ranger rides|1
looking backward 2000 1887|looking backward 2000 to 1887|1
lord of death and the queen of life|the lord of death and the queen of life|1
love affairs of a bibliomaniac|the love affairs of a bibliomaniac|1
love and freindship|love and freindship sic|1
love and mr lewisham|love and mr. lewisham|1
love letters of abelard and heloise|the love letters of abelard and heloise|1
lovels of arden|the lovels of arden|1
arabian art of taming and training wild and vicious horses|the arabian art of taming and training wild and vicious horses|1
arabian nights entertainments|the arabian nights entertainments|1
art of letters|the art of letters|1
art of the moving picture|the art of the moving picture|1
ashiel mystery a detective story|the ashiel mystery a detective story|1
astounding stories 14 february 1931|astounding stories february 1931|1
astounding stories 15 march 1931|astounding stories march 1931|1
astounding stories 16 april 1931|astounding stories april 1931|1
astounding stories 17 may 1931|astounding stories may 1931|1
lure of the dim trails|the lure of the dim trails|1
lure of the labrador wild|the lure of the labrador wild|1
machine that saved the world|the machine that saved the world|1
madman and the pirate|the madman and the pirate|1
magic of oz|the magic of oz|1
make believe man|the make believe man|1
maker of opportunities|the maker of opportunities|1
man against the sky a book of poems|the man against the sky a book of poems|1
man in lower ten|the man in lower ten|1
man in the iron mask|the man in the iron mask|1
man of means|a man of means|1
man that corrupted hadleyburg|the man that corrupted hadleyburg|1
man who knew too much|the man who knew too much|1
man who lost himself|the man who lost himself|1
man whom the trees loved|the man whom the trees loved|1
man who would be king|the man who would be king|1
man without a country and other tales|the man without a country and other tales|1
man with two left feet and other stories|the man with two left feet and other stories|1
marriage at sea|a marriage at sea|1
marrow of tradition|the marrow of tradition|1
master knot of human fate|the master knot of human fate|1
master of mysteries|a master of mysteries|1
master of the world|the master of the world|1
matador of the five towns and other stories|the matador of the five towns and other stories|1
may flower and miscellaneous writings|the may flower and miscellaneous writings|1
melting of molly|the melting of molly|1
melting of molly|the melting of molly|1
